#################### 
E...#.......####...# 
###.#.#####....#.### 
#...#.....#.#......# 
#.#####.#.#.####.#.# 
#.#.....#.#....#.#.# 
#.#.###.#.####....D# 
#.#.#...######.##### 
#.....#............# 
#################### 